hi - xin chào
apple - quả táo
orange - quả cam
good bye - tạm biệt
abalone - Bào ngư
ant - Kiến
bear - Gấu
butterfly - Bướm
cat - Mèo
chamois - Sơn dương
camel - Lạc đà
crocodile - Cá sấu
dog - Con chó
donkey - Con lừa
dragon-fly - Chuồn chuồn
dromedary - Lạc đà 1 bướu
eel - Lươn
elephant - Voi
falcon - Chim ưng
fly - Ruồi
fox - Cáo
frog - Ếch
giraffe - Hươu cao cổ
grasshopper - Châu chấu
hummingbird - Chim ruồi
insect - Côn trùng
jellyfish - Sứa
ladybird - Bọ rùa
leopard - Con báo
lion - Sư tử
locust - Cào cào
monkey - Khỉ
mosquito - Muỗi
mouse - Chuột
mule - Con la
mussel - Con trai
octopus - Bạch tuộc
ostrich - Đà điểu
owl - Cú
panda - Gấu trúc
parrot - Vẹt
peacock - Con công
sheep - Cừu
tiger - Hổ
